1111111111111111111111111
0111110111110111110111110
0101010101010101010101010
1111100000111110000011111
1111101010111110101011111
0111000010011100100001110
0111000010011100001001110
0001001010011100001000010
0111001000011100001001110
0111001000011100101001110